<                                                         <
┌──────────────────────┐        ┌─────────────────────────┐
│                     #│        │#                        │
│ !                    │        │                     !   │
│            │         │        │                         │
└────┐       │         └────────┘     ┌─────────────      │
     │       │                        │                   │
     │    !  │                        │  !                │
     │       │    ┌─────────────┐     │                   │
┌────┘       │    │┼┼┼┼┼┼┼┼┼┼┼┼┼│     │                 # │
│            │    │┼┼┼┼┼┼┼┼┼┼┼┼┼│     │     ──────────────┤
│            │    │┼┼┼┼┼┼┼┼┼┼┼┼┼│   ! │                   │
│    !       │    │┼┼┼┼┼┼┼┼┼┼┼┼┼│     │                   │
│        ┌───┤  ! └─────────────┘     ├────────────┐      │
│        │#$#│          $             │┼┼┼┼┼┼┼┼┼┼┼┼│      │
│ !      │   │         $S$            │┼┼┼┼┼┼┼┼┼┼┼┼│      │
│        │   └────────────────────────┴────────────┘      │
│        │                                                │
│    X   │ E                            !                 │
└────────┴────────────────────────────────────────────────┘