                                                          <

┌──────────────────────────────┐   ┌────────────────────┐
│                              │   │                    │
│   ┌───────    ─────────┐     │   │               $    │
│   │X     @      $      │     │   │!                !  │
│   └───────    ─────────┤     │   └──────┐   ┌─────────┘
│             !          │     │          │   │
├────────────────────────┘     └──────────┘   └─────────┐
│!                                                     E│
│  ┌───────────────┐  ┌──┐     ┌───┬────────────────────┤
│  │               │  │  │@@@@@│   │           !        │
│  │               │# │  │     │   │ S                  │
│  └───────────────┘  │  │     │   └───────────────┐    │
│                 !   │  │     │                   │    │
│                     │  │     └───────────────────┘    │
│@@@@@@    K    @@@@@@│  │        !                     │
│!  !!@         @! !  │  │            !              !  │
└─────────────────────┘  └──────────────────────────────┘
<